....@@@@@@....
..#.##..#.#.#.
..#.#.@@@@....
..#.##..#.#.#.
..###@@@@@@@..
.....@@@......
.#.#.#..#.#.#.
....@@@@@@....
.#.#.#..#.#.#.
......@@@@....
