.@@.@@@@.@@@..
..#.##..#@#@#.
@.#..@@.@.@@..
..#.##.@#.#@#@
##@.@@..@@..@
@@.@...@@..@@@
@#.#.#..#@#.#.
@.@@.@@@.@@@@@
.#.#.#@.#.#@#.
..@.@.@....@..
