......@.......
..###..#..###.
..###.###...#.
..#.@@#@#.###.
..#...#@#@#@..
..@@@@@@@@###.
.#.#.#..#.@.@.
......@.@@.@..
.#.#.#..#.#.#.
...@@.@.@@....
