.@@.@....@.@..
..#.##..#@#@#.
@....@@.@.@@..
..#.##.@#.#@#@
@@@.@@...@@..@
@@.@@@@@@..@@@
@#.#.#..#@#.#.
@.@@.@@@.@@@@@
.#.#.#@.#.#@#.
...@@.@@.@@@..
