.@@.@@@@.@@@..
..#.##..#@#@#.
@.#.#@@.@.@@..
..#.##.@#.#@#@
....@@@@@@@..@
@@.@@@@@@..@@@
@#.#.#..#@#.#.
@.@@.@@@.@@@@@
.#.#.#@.#.#@#.
....@.@@@@@@..
